R 100 100
NO ./images/texture1.xpm
SO ./images/texture1.xpm
WE ./images/texture1.xpm
EA ./images/texture1.xpm
C 156,140,36
F 15, 20,054

we
111111111111111111111111111
        10000000000000000001
       10000000000000000001
      10000000000000000001
     10000000N00000000001
    10000000000000000001
    10000000000000000001
    11111111111111111111
