R 2147483989898998948 214748454545348

NO ./images/texture1.xpm
SO ./images/tex  ture2.xpm
WE ./images/texture3.xpm
EA ./images/texture4.xpm
S  ./images/textures.xpm


C 0   , 0 , 0
F 25 ,1,00000255


111111111111111111111
100000000000000000111
1000000020000W0000011
111111111111111111111